+--+--+--+--+--+--+--+--+--+--+--+--+
                                    |
+--+--+  +--+--+  +  +--+  +  +  +--|
|     |  |  |     |  |     |  |  |  |
+  +  +--+  +  +--+--+  +--+  +  +  |
|  |  |  |  |        |     |  |     |
+  +--+  +  +--+--+  +  +  +--+  +--+
|           |     |     |        |  |
+--+--+  +--+  +  +--+--+--+  +--+--+
|     |     |  |  |        |  |  |  |
+  +  +  +  +  +  +  +--+  +  +  +  +
|  |     |  |  |     |     |  |  |  |
+  +--+--+--+  +--+--+  +--+  +--+--+
|        |     |  |           |  |  |
+--+--+  +--+--+  +  +--+--+--+--+--+
|           |  |              |  |  |
+  +--+--+  +  +--+--+  +--+  +--+--+
|        |     |     |  |     |  |  |
+--+--+  +  +--+  +  +  +  +--+--+--+
|        |        |     |            
+--+--+--+--+--+--+--+--+--+--+--+--+